1,1,1,1,1,1,1,2,2,2,1,1,1,1,1,1
1,3,3,3,3,3,3,3,3,3,3,3,3,3,3,1
1,3,0,4,0,0,0,0,0,0,0,0,0,0,3,1
1,3,0,0,0,0,0,0,0,0,0,0,0,0,3,1
1,3,0,0,0,0,0,0,0,0,0,0,0,0,3,1
1,3,0,0,4,0,0,0,0,0,0,4,0,0,3,1
1,3,0,0,0,0,0,0,0,0,0,0,0,0,3,1
2,3,0,0,0,0,0,0,0,0,0,0,0,0,3,2
2,3,0,0,0,0,0,0,0,0,0,0,0,0,3,2
2,3,0,0,0,0,0,0,0,0,0,0,0,0,3,2
1,3,0,0,0,0,0,0,0,0,0,0,0,0,3,1
1,3,4,0,4,0,0,0,0,0,0,0,4,4,3,1
1,3,0,0,0,0,0,4,4,0,0,0,0,0,3,1
1,3,0,0,0,0,0,0,0,0,0,0,0,0,3,1
1,3,3,3,3,3,3,3,3,3,3,3,3,3,3,1
1,1,1,1,1,1,1,2,2,2,1,1,1,1,1,1